   C  222,100,102
   F     010, 43,2

WE ./maps/path_to_the_north_texture
NO ./maps/path_to_the_south_texture
EA ./maps/path_to_the_east_texture
SO ./maps/path_to_the_west_texture









11111111111111     11     1
        111101111111111111011111
        1000000000110000000000001
        1011000001110000000000001
        1001000000000000000000001
111111111011000001110000000000001
100000000011000001110111111111111
11110111111111011100000010001
111101111111110111011110011001
11000000111101011100000010001
10000010N00000001100000010001
10000000000000001101010010001
110000011101010111110111100011
11110111 1110101 101111010001
11111111 1111111 111111111111


