SO ./maps/path_to_the_south_texture
   C  255,255,255
   F     010, 43,2
WE ./maps/path_to_the_south_texture
  NO                                  ./maps/path_to_the_south_texture
EA ./maps/path_to_the_south_texture

11111111111111111111111111111
10000000000000000000000000011
10000000000000000000000000011
10000000000000000000000000011
100000000000S0000000000000011
10000000000000000000000000011
10000000000000000000000000011
11111111111111111111111111111
