SO ./maps/path_to_the_south_texture
   C  55,100,255
   F     140,58,52
WE ./maps/path_to_the_south_texture
  NO                                  ./maps/path_to_the_south_texture
EA ./maps/path_to_the_south_texture

11111111111111111111111111
       10000000000000000001
       100000000000000000S11111111
111111111111111111111111111