SO ./maps/path_to_the_south_texture
   C  255,255,255
   F     140,58,52
WE ./maps/path_to_the_south_texture
  NO                                  ./maps/path_to_the_south_texture
EA ./maps/path_to_the_south_texture

111111111111111111111111111111111111111111111111111111111111111111111
100000000000000000000000000000000000000000000000000000000000000000011
100000000000000000000000000000000000000000000000000000000000000000011
100000000000000000000000000000000000000000000000000000000000000000011
1S0000000000000000000000000000000000000000000000000000000000000000011
100000000000000000000000000000000000000000000000000000000000000000011
100000000000000000000000000000000000000000000000000000000000000000011
100000000000000000000000000000000000000000000000000000000000000000011
100000000000000000100000000000000000000000000000000000000000000000011
100000000000000000100000000000000000000000000000000000000000000000011
100000000000000000100000000000000000000000000000000000000000000000011
100000000000000000100000000000000000000000000000000000000000000000011
100000000000000000100000000000000000000000000000000000000000000000011
100000000000000000100000000000000000000000000000000000000000000000011
100000000000000000100000000000000000000000000000000000000000000000011
100000000000000000100000000000000000000000000000000000000000000000011
100000000000000000100000000000000000000000000000000000000000000000011
100000000000000000100000000000000000000000000000000000000000000000011
100000000000000000100000000000000000000000000000000000000000000000011
100000000000000000100000000000000000000000000000000000000000000000011
100000000000000000100000000000000000000000000000000000000000000000011
100000000000000000100000000000000000000000000000000000000000000000011
100000000000000000100000000000000000000000000000000000000000000000011
100000000000000000100000000000000000000000000000000000000000000000011
100000000000000000100000000000000000000000000000000000000000000000011
100000000000000000100000000000000000000000000000000000000000000000011
100000000000000000100000000000000000000000000000000000000000000000011
100000000000000000100000000000000000000000000000000000000000000000011
100000000000000000100000000000000000000000000000000000000000000000011
100000000000000000100000000000000000000000000000000000000000000000011
100000000000000000100000000000000000000000000000000000000000000000011
100000000000000000100000000000000000000000000000000000000000000000011
100000000000000000100000000000000000000000000000000000000000000000011
100000000000000000100000000000000000000000000000000000000000000000011
100000000000000000100000000000000000000000000000000000000000000000011
100000000000000000100000000000000000000000000000000000000000000000011
100000000000000000100000000000000000000000000000000000000000000000011
100000000000000000100000000000000000000000000000000000000000000000011
100000000000000000100000000000000000000000000000000000000000000000011
100000000000000000100000000000000000000000000000000000000000000000011
100000000000000000100000000000000000000000000000000000000000000000011
100000000000000000100000000000000000000000000000000000000000000000011
100000000000000000100000000000000000000000000000000000000000000000011
100000000000000000100000000000000000000000000000000000000000000000011
100000000000000000100000000000000000000000000000000000000000000000011
100000000000000000100000000000000000000000000000000000000000000000011
100000000000000000100000000000000000000000000000000000000000000000011
100000000000000000100000000000000000000000000000000000000000000000011
100000000000000000100000000000000000000000000000000000000000000000011
100000000000000000100000000000000000000000000000000000000000000000011
100000000000000000100000000000000000000000000000000000000000000000011
100000000000000000100000000000000000000000000000000000000000000000011
100000000000000000100000000000000000000000000000000000000000000000011
100000000000000000100000000000000000000000000000000000000000000000011
100000000000000000100000000000000000000000000000000000000000000000011
100000000000000000100000000000000000000000000000000000000000000000011
100000000000000000100000000000000000000000000000000000000000000000011
100000000000000000100000000000000000000000000000000000000000000000011
111111111111111111111111110000000000000000000000000000000000000000011
111111111111111111111111111111111111111111111111111111111111111111111